1 1	1 1	1 1	4 1	1
1 9	0 0	0 0	0 0	1
1 0	2 3	2 2	0 0	1
1 0	0 0	0 0	0 0	1
1 0	2 2 6 7	0 0	1
1 0	0 0	0 0	0 0	1
1 0	2 2	2 5	0 0	1
1 0	0 0	0 0	0 0	1
1 1	1 1	1 1	1 1	8