1 1	1 1	1 1	4 1	1 1 1 1
1 9	0 0	0 0	0 0	0 0 1 1
1 0	2 3	2 2	0 0	0 1 1 1
1 0	0 0	0 0	0 0	0 1 1 1
1 0	12 11 6 7 0 0 0 1 1 1
1 0	0 0	0 0	0 0	0 2 1 1
1 0	2 2	10 5 0 0 0 2 1 1
1 0	0 0	0 0	0 0	0 0 1 1
1 1	1 1	1 0	0 0	0 0 1 1
1 1 1 1 1 1 0 0 0 0 1 1
1 1 1 1 1 1 1 1 1 1 1 1 
81 81 81 81 81 81 81 81 81 81 81 8